####################
#  B  B  B  B  B  #
# R    V    V    R #
#    B  B  B  B    #
# V    ###    V    #
#  B  B  B  B  B  #
# R    ###    R    #
#    B  B  B  B    #
# V    V    V    V #
#  B  B  B  B  B  #
####################