
####################
#        B     B   #
#    R           B #
#          B       #
#   B    ###    B  #
#     B          B #
# B    V     B     #
#         B        #
#    B        B    #
####################
