####################
#   B   B   B   B  #
#  R  ###  ###  R  #
#   B   B   B   B  #
#                  #
#   ###  V  ###    #
#   B   B   B   B  #
#  R  ###  ###  R  #
#   B   B   B   B  #
#                  #
####################